25x25
XXXXXXXXXXXXSXXXXXXXXXXXX
XCCCCCCCCCCCCCCCCCCCCCCCX
XCCCCCCCCCCCCCCCCCCCCCCCX
XCCCCCCCCCCCCCCCCCCCCCCCX
XCCCCCCCCCCCCCCCCCCCCCCCX
XCCCCCCCCCCCCCCCCCCCCCCCX
XCCCCCCCCCCCCCCCCCCCCCCCX
XCCCCCCCCCCCCCCCCCCCCCCCX
XCCCCCCCCCCCCCCCCCCCCCCCX
XCCCCCCCCCCCCCCCCCCCCCCCX
XCCCCCCCCCCCCCCCCCCCCCCCX
XCCCCCCCCCCCCCCCCCCCCCCCX
XCCCCCCCCCXCXCCCCCCCCCCCX
XCCCCCCCCCXCXCCCCCCCCCCCX
XCCCCCCCCCXCXCCCCCCCCCCCX
XCCCCCXXXXXCXXXXCCCCCCCCX
XCCCCCRECCCCCCCXCCCCCCCCX
XCCCCCXXXXPXXXCXCCCCCCCCX
XCCCCCXCCCCCCXCXCCCCCCCCX
XCCCCCXCCCCCCXCXCCCCCCCCX
XCCCCCXCCCCCCXCXCCCCCCCCX
XCCCCCXCOCCOCXCXCCCCCCCCX
XCCCCCXCCCOCCXCXCCCCCCCCX
XCCCCCLCOKOCCRCRCCCCCCCCX
XXXXXXXXXXXXXXXXXXXXXXXXX